>C688J35102_110110644
GGAGGACATAGTCTTTTATAGAACCCCGTAACGACTGACTGAAAGGGAGGCTTTTAATCC
AATTAAAGGCAACACGCCAGCACTTCTAGGTTTCAGCCAATTATGGTGTTAGCATACTGG
GCGATGGACGACGGCTATAAGGACAGAGGCAACTTTAGATTGCAGTCTTAATACGGTCCA
ATCTACCCAATACAGGATCTATGTTAAGACCAACTCTATGGTTCAATTCCGAGCTTTAAT
CTCTCCTTATTTCTTTCCTTCCACCCAGCCTAGTACCCCTAGCTGACCTCCGGGCACC
>C688J35102_119259364
AATGTAACGGGTCTATAGTAGTTGTCTCCCTGGAACCCGGTTTGCCGACCCATGAGCCTG
GAAGGCCCGGGGGTAGGCCAGCCAAACTCTCTCGTAGGGAGCCCAGGGGGGCGCGGCAGC
CGGCACAGGCGCAGAGCTCCTCCGCCTGCCTCACCGAAACCCTGTCCTAGGCGCCAAATT
CTGGGGGTAGCGGAATACCCAGCAAATGGAATGAAGGTGGCTCATCGAGCCGGTGGACAT
AGCTGGGCTGAGAATGCTGACATGAGTAGCCTCAAAGGAGGGGAATTCCCTCTTCGCCGA
AAGCAGAAGGGTTTCATATGTTAGGTCCATACCAGCATGAGTAAAGCAGCGGCCTCTAAG
GCAGCTTAGGGTGGCGGATCCCGAAGGGCTTCGAAGGAGTCAGAAGGACCAAAACTCTGC
CTGGCCAAGCCCCCGAGGTTGCCTCAGGTCAAGCCGAGGGCCTGTCCCTTGGCAACCCGA
GGTCTCGGCCTTGGGCTGACACGAGCGGTGCCGATGAGTAACTCTTCTGTAGGGCAGTAA
CCTTCCTTATAAGTATACCTTGCCGTTACGGACCCTGGTCATACCCTGCCCCAACTCTCG
CACACAAGCGAGTTGTGCTGGAGGCTCTGCCTTCGGCAAGTCTGCCCGGGCAACCCCCCG
GCC
>C688J35102_120781595
AAATTACTTTGAGTTGAAGGTATAGTCTAAACAGATATGAAAATTTCTGAATAATTGCAG
CAAGATGATGGTGGGTGCATGGTAATAGCCCTAGCAAAAGCGACCCCAGTTAGCCGGTGA
TAGTACCGACCATCAGACCCGAACCCAGGTGATCTTGCCATTGCCAAGTGCTATTTAATA
AGACTGAACGGATGTTTAGGACGTCCTATTTAGGGGTGACCCTTTATTAAAATCTGGCTC
ATAACGGTGAAGCCTAAAGTCTTAAGAGGCCATGGTAATACCGTGGGAAGTTCTATAATC
GTAGAAACCACCTTCTTAGAGATAGAGATACTCTTAGGAGGACTTAGTCTTTTATAGAAC
CCCGTAACGACTGACCGAAAGGAAGGCTTTTTAATTAAATTAAAGGGCAACACGCCAGCA
CTTCTAGGTTTTCAGCCTATTATGGTGTTAGCATAATATACTAGGTAGACTAACAAAGCA
GGAAGACTATGAAGAACAAGTTAAAAATGGCTTAGAAGTAAATAACAATATTATCATCTT
TATTATGAAATCACCAAACTCACAGCCAGCTCTTTCTCCTATTCAACGTTACATTCTCGT
AGGAGGATTATTAGGAGATCTTTCTATTTACAGAGCTAAACTAACCCACAATGCTCGTCT
ATACGTGCAACAAGGGGCTGTTCATATAGAATATTTGAATCATCTCTCTTCTGTCTTTCA
GAATCTATGTTAAAGCCAACTCTATGTTTCAATTCCGTGCTTTAGTCTCTCCTTATTTTC
TTCCTTCCATGCTATACAAATTACAGTAAGGTCTATTGGGTAGGGTAAGGGTAGGGTGAG
TATATTATCTAACACCTAAAATTGGTAGGAAGTTGAAGGTATAGTCTAATCCAGTATGAA
AGTATTGGGTAATAGGTCCGTTGCAAGGGGCTCCGAAGAGCTGTGGCAAGGGGTGATTAA
TCGCCCGGATTATTGGTGACAGTAATCATAAATTCGACTCATAACGGTGAATCCTAAGGT
TTCTCAACTATGGAAATACCGTGGGAAGTTATAGTAATAGTAAAAACACTTGTACTTAAT
TGAGTACTATCCCTCATTATAGGGCTTTACTATTAACCCCGTAAAGACTGATCCGAAAGG
AGAGACGTTAGAGATAGTAATCTAATCGTAACACGTCGACACTCTTATGTTTTAACTAGT
CATGAATCTCGACCACACTTGAGTTCATATTATTAACCACTTTATCCTTAAGAAGTAATT
AGTTTATAGTTATAATTATGCTAAACTCTACAAACCCAAAATTAACACCTGCTTACATTA
GTGGGCTGGTTCAAGCAGATGAGGGATTACAACAGATCATAGATCTGGCTTATAATATGA
ACAAAGAGGGCAAAGGTCGACGTCTCACAAAGGAAGAGTTTATCCAAAAGATGAAAGCTA
AACTTTAGCCGTGGGTCCTCTCCTAAAAAGTCTTCATTTGATGAGAATTCAGAATTCTAA
AACTAGTAAGAGTTGAAGGTATAGTCTAAACTGGTTCGAAAGAATCAGAATTTATTGGAA
AGG
