>Ga0063455_102207848
AACCTAGATTAGAGCGTAGCCACTGTTCAGAGCAGCAACATTGACAAGGGCCCTTGTCAT
GGTTCTTGTGATCTGTTCTTGCTTGATCCACCTCGGCTTGCCAAAGACGGAGCCTCTGGC
TGTTGCCGGCTCGGACAGGCACCTTCGGTGTCTGCTGAGCCCCCCGGCCTGAGGACCAAG
GGCCCTCAGTCCTTGGGCCGAGGGGGGCGGCGACCGCCGAAGGCGAACCTTCGCTTGTAA
GGCAACAAACACGGGGCCTATCTTTTTAGGTATCTGATTCTAGGTTACGAGGTGGCGTGG
CAGCCGGCACAGGCGCAGAGCTCCTCCGCCTGCCTCACCGAAACCCTGTCCTAGGCGCGG
GGTAGCGGAATACCCAGCAAATGGAATGAAGGTGGCTCATCGAGCCGGTGGACATAGCTG
GGCTGAGAATGCTGACATGAGTAGCCTCAAA
