>C688J14111_10000288
CTAGGGCCCCTTGGGTCTCAGGCCGGGGGTTGCCCAGCTGCAGCTGCATACGTATGCTGC
AGCAGGTCTACGCAGGCAAGTTCGCTGACTATCACTTCCTCTTGCCACTATGCTTCGTAC
CTcccccccTTATCGCCAGCAATAGTTGTCTGCAAATCTGACTAACATGCTCCTTCTAAT
TCTTCGTCTACTTCCTTATTTCAACTTACCTCTACTATTTTCAACCTAGCTATACCACTC
GACCAAAAAGAAGATGCAATTTAGGAGTAGGTAATGGGAGTTAAGAGGACTTACAAATAG
TCTCAGTAGGGGGATAGAATAACCTGTTTATAGAATAAGAGGAAAGGAAGCCCTCGATAT
AGCGGACAGCAGCCTCCGCACCAGAAGGTGATTATAGTTCAATTGGTAAGAACGTCAATT
TGTGGTATTGAAGCGTCTGGGTTCGAGTCCCAGTATTCACCCTATCTCCCACCTCCCTTC
TCCCTCCTCCTTATTTCAGTTCCTAACATATTTTGCTTCTAAACTTCTATTACTTAGACC
CACGGGTCGTAAAACTCCTCGTAAGCCACCTCATAAAAGCCTTCCTATTAAGGAACCTAA
CAAAATTCATTGCCCTACTAATTATTGATATTAACCAAGAATTGATGACAGCTTATCGAG
TGATTAGGATAATCCTATTCTATTAATGAAGTTATTGCAAGAATACAAGAGTTTACATAG
CTATCTATTTTTCATAGATTGAAAAGAGCAAATACCATCTGAACTAGGTAATGTTGAAGC
CTCTGGCAAGTTGAGATTGAGTAGCAGAGATTTGTGCTACTGTTTGCTCCAGAGCATCAA
GTCTAGATGTTAGGGTTGGGTCAGTATAAGGAGCTGCACCAGTTGTTGCTGGGTTAGCTA
TCGCTGCGGATGTTGGTGAGATGACTCTATCAAGAGCATTGGCTATAGATTCAGCTAGTC
TCTCATAACCCTGAGCCTTACGCTCCTGTCGTCTGAGGAGACGATTGTTTACTTTCATCT
CATTTAAGAGTAGGTTTAAAAGTTGTGTATCAGTTGAAGCTGCAGGATCAGGATCAAGAT
AAGAAGTAGAAGTTTGGGGTTTTGGAGTTCCTTCTCCTATCTCTTTGATACGGACTTGTG
TGTCGAGGGTAAACTCCTCATCATAATCTTGTTCCATTTTGGCAAGGACCCGGTTGCCCA
ATGGCAGGCCATCGGTCTGCCCGGGCAACCCCCCGGCCTTGAGCCCAAGGGcccccccTG
CAGCTGCATACGTAAGCTGCAGCAGGTCCGGGGGCCAAGCTGAGCTCATAATTCATTCTA
AGTTTGTTAATGCCAGCCTTCGGCCCCGAGGCCGTCGGGCCCCTTGGGTCTCAGGCCTGC
TGCAGCATAGTATGCAGCTGCAGGGGGTGCCTGAGTCTATGAAAAGAGAAGGGCCAAGAG
TTATAGGCCCATTACTTGAGTTTGGGTGAATAAGAAGGGCGTAAACAGTGTTGGGTCGTA
GATCTCTTAAGACTTGAACCATGTTATCCCAGAATCGGATATCGTGCATAGATGGTAAGA
TGTAGATTACCCAGGCACCTTTAGGAAGAGGTTTTCCTACTTCCCACTGAGGAAGAGCTT
CTGTGTTAGGAGCAGTGAATCGTGCCGTATGTTCTGTGTAGATTGCAAGAGGAGAAGCAG
AAGTAGAGAATTGAGCTGTGCCGAATTGCACCCCAAATTGAATACCTCTGCTGAATAGCA
GACCACCAATTTGATCAGCAACCATTGACCAGCTTGGAAGGAATGCAGGGTTAGTCATGT
GAACGGAAGCCTGAGTTAAAGTCCTCAGGACAAAGAGAAGTTCCTCAGAAAAGAAGTAAC
CTGAGAAGGAACCTATCGGGGATACAACTCTCCCTTGGTAAGAGATGGGTAAAGACCAAT
GAATTCATTTACAGGAGATTTAACTGTGGCTTCTATTTAACCAAAGAACTCTCCTTGGAG
AAGGGAGGAGGGAAATAAAGGCAGAGCTAGTAAAGAAAGAGATTGTAATACTATGAAACT
CAATGAGTTGTTTAAGAAGCATAAAGAATTGGAAGATGAGCAGCTCAGAGTAGAAAGGTT
TAGGGATATTTTAAGGAAGAGTCCCCGGGCTAACCTGCTGCAGCTTACGTATGCAGCTGC
AGGGGGCTAGCCTAGGGGACCGGGGCAATAAAGAAATTAAGGATGTGATTGTTTACAAAC
AGGTCAATTTTCTAACCATCCCgggggttggggggTAGGTACTCTTCTTTTCTTCGAAAC
CTAGTTTCCTTGTAATTTTTCTCTTTCTTAGTTGCCTCATTCTAAAATTCCCCCAGGTCC
AAATACTTAGTGGCCACTCCACACTGAAAACACGGCTATGTTGGAATTGGCAGACAAGTG
TGATTTAGGATCACGTGGGTAATACCGTGAGGGTTCAAATCCCTCTAGCCGTATTCTGAG
CCTAGCTAACCTACCATAGTTAATTTCAATAGGGTTGCCTAGTTACCATCCCTGAccccc
tccccccTATTAGCCTCCACCCCTACCTATTAGAGTACCCTAGGAAGCATTGGTCTGGGG
CAAAAGGTTGGTCTCCGTAGGCCTGCTGCAGCATACGTATGCAGCTGCAGGGGAAGCATT
GATGATGTTTTAGGGTTAATTAACCAACAATTGAAACTAGCTAAGATAACTCCCCATACT
CTAAGAAGAACCTTTGCTTTGAATCTCTTAGCAGAGGGATATCCGTTAAATCAACTCCAA
GCTCTACTTGCCCAGGGGAATTTCTAAACTACCAATTCTTACACTAAGTCAAAGTAGCTG
AGAATCCATTGAAGTATCTATTAGAGTAGTAGAAAAGAGCCACAAACAATGAAAAACAAC
AAGAACAAACATATTGTGGAAGAGTATCAAGGGAGTATGCGGAAAGAAAGTAAGAAATTG
CACCTTCATTTTACAGAGGCTTTTTATAACAATAGACTCCGAGGAGTAGTTAATTTGAGT
TTAGAGAAGGTGTAGTCATGATTAGTCGTTGACAAATTCCTAACGCTTGTCGTGAGTGCC
TTTGCAGAGAGAAATACCCAGAGCCTTTGGATACTCTTTTAGAGGATGTTTATCAGAAGG
GGCCGGCACAGTCTTTTGACGCCAATATCTTACTAATTTCTATAGCTCAAGGAACAGGAG
ATAAATAATGACACTAAAAAGGAAGTATGCTTATATTGAAGACTGAATCTTAGAAGAGCC
TAAGAAGGATAAGTATAAGGGCCCTAATGGCGACCCTGGACCCAAAGGCGATGGGGCTAC
ACTTAACTTTAAAATTGATTTCCTTCTCAATGTTGGGGATAACTGAAAGACTCAAACTTC
TCTTGCTTCTAACAATAACTATCTTTATATCAAGCTTAGAGATAATGACATTGTAGACTG
CTTTTGTTTAAAGGACGGTGATAATAAGGAAGACTATTGAAGACCCAGTGAAGATTGAGC
TAAGGACTCTTTGGACTATTTCCGTATTTGGGCTAAGATGTATGGGAAAAGAATTGAGGA
AAGCAAGGTAACAAAGGATAATATGACTTACCCTAGAACCTCCTATGAGGTGGAAGGCTG
GGAAAAGGTTACTATCTGCTATGTAGAGACTACACTTTATTACTGTGGGTATGTCACGGA
GCTGGATATTAAACAGTGAGACGACAAGAGAAAAGAGCCTAAGGGAGAGAAGGGAGACCG
TGGGAATGATGCCTATATTCCTGAGAGTGTTTGGGATTATAGAACGCTAGCCAATTGGAA
ACTAGATTAAAGATATGAAGTTTTGTGGAAGCCCTGTAGGATATAAAATAGGAGGATGTG
TCTATCAGTTCGACTTTTTCTTTAAGATTTCAATCAAAATACGTATCCGAAACCTGGAAA
TAAGGATATTCCAAAGAGTAATATATCTGGCAATGACGCATATAATCCAAATTTATAACC
CTCTAGAGCAGTTTGAGATTATCAATTTTATAGCAATGGAAGGGCCACTGTTCGGGTATA
TACAAATCGGGCTGACTAACATAGGCTTTTATCTGTTACTGGCCTCACTCTTCCTAATTT
TTCTACACCTTCTATATAATAGAGAAGGGGTGCTAGGGCTGGGTAATACATTAATGCTTT
GTATGGAATCTCTTTTTGGATTTGTACTCCAACTGGTAAAGAACCAAGTAGGTCCTACTT
GGCAGTCCTACTTTCCTGCTGTTTACTCTCTGTTCTTATTTATACTGTCTCTAAACTTAG
TTGGTCTCATTCCTTACAGTTTTACTGCTACGGCCCATTTTGCTTTTACCTTAGGTCTTA
GCTCTACAATAGTACTGGGGGTAACCTTTCTTGGTTTAAGGCTACATGGATTCCACTTCT
TTTCTTATTTTGTGCCAGGGGGCACTCCTTTAGCTTTGGTTCCTCTTTTAACTGTAATCG
AAACTGTCTCTTATGTAGCTCGTGCTTTCTCTTTAGGTGTACGTCTGAGTGCCAATATGC
TGGCCGGTCATATTTTATTACATTTAATTGCCTCTTTTTCATGGAAATTTATAACAGGTT
CCCTAATGGGTTTACTCTTGGCTCCTCTTCCTCTTATTCTTTTATCCCTTTTATATGGCC
TGGAGGTTGGTGTTGCCTTAATTCAGGCTTACGTATTTGCCTTACTAACATGTTCTTACA
TTAAGGATGCTATTTTTCTTCATGATTAATCTCCCTCTACTTCTTCTACCCAAATCTCCC
CCTCTAAACCTTTTGGTTTAGCTAAACGAGAATATTCTACTTTATCTAGCTTGTCTAATT
CTTCTATGAACTGCACATCTGTTGTTCTTAGGGGTGGCAAAGAGAACTTCTCTTTCTTTT
CCAAATATTTGTTTCATTGGATTTACAATCTATTGATAAAATGACTTCTAAGTACGATAA
AGGTCACTAAAGATATCAGCTAGGGGGCGTTTAGAAATACTGTTTCTAAGGATATTCTTA
TCTAATGATTAGATTTTAGGATTCCCCCCTCTCCAATACAGCGCTTGAAGCAACTTCATC
TTAGCGAGCATAGGTTAGTGGTAAACCGTACCCCTTCCAAGGGTGATTCGCGTGTTCGAG
TCACGCTGCTCGCACTATCTTATTCTGTATATCTTATTAGCATTGTCACTGGTACGCCTA
CCTGACCCTCCCAGGTCAACAAGAGTAGGGGATGATTAGAGCAGTGACAACAACAATTTA
CTGTCTTGGCTGTTATAATACTAATAATACACTGATTTCAAGGATAGGTCTAGGTGGAAA
CTACTCTTATTCTCATGGAATTGTGGTCCTTGAAGAAGCCTACGAGTTTGATCAAAAGAC
CTACAGTGCCCTTCGGGAAGCAATCCGAGGTGTTGACAAGATGACATGAATTCTCCGTAC
TAATCCTTGGTTAGCTAACGACTGGTTTGTCAAAAGGTGTTTCTCTGTTGTTCCTCTAGG
AAGAGAAAGTGATGCTTGAGGGTTCAGGTAATATCTTTAAAGAGGTAGGAAGAGAAGTTT
ACCACTACATGAGATGAGATGTTAACACTCAACTACCACAGACACAGAGAGACTATCTCG
AAGAGGTGACAATTAACAATCCAATGAGAGCAAGAAGAGTTTCTTATGGTCTCCCGGGTA
CTTCTGAGGGTATGGTCTTTGCTGACATTGTTCATAAGATTAAGACAGGCTTTGAACTCA
AAAGATGAGAGGTATTCAGTGCTGGTGTTGATGTTGGTCATGTTAAGAAAGAGAAGGAAA
AGATCGATGAAAGATTAAGAAATATAAGGTCCCTAACAAATGGGTTCTTTTGAAATAAAG
AGAATGGAGACACCCCCCTAACCCACCCCCTTGGGTCTCAGGCCTGCTGCAGCATACGTA
TGCAGCTGCAGGGGCCCATTGAACTCTCTAAAACTTCTAGCCCTAACAAACTTCATCAAC
GTTCCCCACTTATCTTCTCCTGTCTTCAGCAAATTCAAAAGAGCAGCTTTCTCTGGAACC
TTAATTACACATTCCTCTGGCTCGGTAGGATTAGATCTAACAAACGTGATGGGCTGTTCA
AGTCTATACAGTTCCATATCCGCCGGTCTTTTAACTCTTTCTTTGCTTCCTGATACTCTT
TATCATACTGGTCATCATCAATATCCTCTATATCCTTAAAAGGTCTATTGTCCCATATCT
CATTTACCTCCTTTACTCTTTTCTGATACTCTCTTATAAGTCCTATTAACCCACTAACTT
TGGTTCCATCTTTAAAAACAAAACCACCCTTTACATCTGTAAACTACTTTAAACCTTCAA
GGGTCTTTATATCTACTACATCAAGAAAATACCCAGACCTCAATGTACTCGTCAATCCAT
CTTCTCCACTCAGTAATAATCCAAATCTCTTATCTCTCCTATTCTACTTAACACTTCATC
TAAATCAACACGCTCTGTGCAATTATCCAAAATTATCAGCTCTATTCCTTCTAGATTTAA
CAACTGTTCTGTTGCTCTTTTAACCTTAAACGGATATTTAGCACGACAACACATGATTAA
CCTAATTACACTCTTCCAAGTACTCATCATTCAACTTCTGACCCTTTCCTATCTCCTGAT
CCTCATAATCCTTTATAGAGTTCATCAAAGCTCTCTACACTGACAAGAGAGGATTGGTTT
ACCGTAGGAATTGGATTAACGGCCGGTGTATGATTGAAATACTTGGATACTGCATCCCCA
GCCACCTTGACAACAGACACCTGTCCTACCGTCCTAATCAGAATATTGATAGTTGCTGCC
GTTATCATTTCCTCTTAAGCGGGTTCTAAATAGACTGATCAACTTGATAAACTTAACAAA
TCCTAACTCGACATACTAATACCATCTCTTCTAAAACAACAGttttttttGAGACATGAC
TAATGTGAGGGATAAGTATCTATTTCTAAGTTCTCAGGGATATAGAGGGTTGGTAATGGG
GGAATTGGGTCTTTTTAGGTCCTTTAGAAGTATTGGTTCGAGTGTTCGAGGTTTAGAAGT
TCTACAATTTGGTTTCCAATTTTAAGGAGAAAATCCGCAGCGATCTGCAATGTAAAACCA
AGTATAACAAAGGGGTCACTAGGGATGACTGGGCAATGGACCGGAATGAGGTAAAATCCA
AACTGTCGAATCCTTACAAGGTATGAAGATCCAACCTGGTCTCGACGATCAAGGCCAAAA
GGTACCCCGCCTACCCTGGGAACCGAAACATCCAAATACCAGGAGGAAAGGAAATCAACC
GAGACTCTACTAGTAGTGGCGAGCGAACGTAGACAAGCTATCTCTGTCAGGTCACGAGCT
CAGGCAACCGACCTGATCTGCCCAAGGCCGAGCCTCCCTGCCAAGATCCCGCTCCTTCGA
GACCGGTTGCAAAGGTAGTCCGCGGTCTAGCAAAGGCACAAACAATAGCTTGGAATAGCT
AGCCATAGATGGTGATAGCCCAGTGATGGCACGGCTTTGCTCACTCTTTTCTGTACCTCG
ACCCCTTCGAAGAAGCCTCCGGACCCGGTTGCCCAATGGCAGGCCATCGGTCTGTCCAGG
CAACTGGAGCAGGTCAAGGTCTGGCCTTCCCGTGAGTTCGCCAAATCCCGGTACCTCCGT
TGTGGGACAGCGAACTTCGCCACCCCGGCCCTTGAGCCCAAGGGCCCCCCTGCAGCTGCA
TACGTAAGCTGCAGCAGGTCCGTGGCCAAGGGTCCCTAAGGGAGTACTATCGGGTCTGGC
GAGGGTCAGGGCGGTGCCCGGGAGAATTGGCGGCTTGCCAAGCTGCTTTTATACTACCCT
GCCTGTTAAGGCAGGAAAGGTGTTCCATCATCAAGGCTAAGTATGCTCCATTGACCGATA
GTGTAGAGTACCGTGAGGGAAAGTTGAAAAAGCAGGTAGTAAACTGGTGAAAAGCCTGAA
CTAGTGGCTCCACAAGCAGCTGGAATCACAGCAGCCATTGGCTCCGGCTCAATGTGTGAT
GACAGCGTACCTTTTGCATAATGGGTGAATTGCTTGCCCATGAGGATTGTGAAATCCTTT
GTAAAACTGACTCATGACCAGGAATGGTCGGTATTATGACAAGTTCGTAATGCTAACGGT
GAAACCTAAGGAGACTCTTCTCTATGGCAATACCGTGGGAAGTTGAGAAATCGTAGGAAT
AAGGTGGACATATGTAGTCCATTAGAGTTATTCTGACAACACATTGAGTGAATTAGAATA
CTCCTTTTTCTCAACCCTGTAACGACTGATTCGAAAGAAGAGACCAACATAAATTGGTAA
CACGTCAGCACTCCAATATTCCATGAAATCATGGTAATCAATTCTGAATGAAATTATTAA
AGAAGTAATGTCAGCCTTATTTGTTACCGGTTTTATTAACTACCCCATTGTTTATTATCA
ACTTAATCTTGACCCTTCTCTATAAATTGATTTCTTCTTGATCTTATCTCGGGTTTTATT
AACCTCATTCTCAAATTCCCCCATAAACTTATTATGGTTTTTAATTAAGAATTGTTCACC
TAAAATTTCTTTGAGTTGAAGGTATAGTCTAAACAGATATGAAAATATCTGAATATTTGC
AGCAAGATGATGGTGGGTGCATGGTAATAGCCCTAGCAAAAGCGACCCCGACCTGATCTG
CCCGAGGGTTGGTTTGCCGAGGGCTTCGGCCGGTGATAGTACCGATCATCAGACCCGAAC
CCAGGTGATCTTGCCATGGCCAAGTGCTGTTTCATAAGACTGAACGGGTGTCCGGGACGC
CCTGTTGAGGGGTGACCCTCAATTAAATCTGGCTCATAACGGTGAAGCCTAAGGTCTTAA
GAGACTATGGTAATACCGTGGGAAGTTCTATAACCGCAGAAACCGCCCCCTTAGAGATAG
AGATACTCTTAACGGAGGACCCACTAGTCTTTTATAGAACCCCGTAACGACTGACTGAAA
GGAAGGCTCTTAAGAAAATTAAAGGGCAACACGCCAGCACTTCTAGGTTTCAGCCAATCA
TGGTGTTAGCTTAATATACTAGGTAGACTAACAAGGCAGGAAGACTATGAAGAGCTAGTT
AAAATTTGACGTAACTTAGAAGTCAATAGTGATATTACATTTGTTTGATGAAATCACCAA
ACCTACAGCCAGCTCTTTCTCCTATTCAACGTTAAATCCTTTTCGTAGGAGGATGTTAGG
AGATTGTTCTATTTACAGAGCTAAACTAACCCACAACGCTCGTCTATAGTGCAACAAGGG
GCTGTTCATCTAGAGTATTGAAATCATCTCTCTTCTGTCTCTTCCAGACATCTATGTTCT
TCTGGGCCAAAACTGAGTTTTTCTTTGGATAAACGAAGCAATACAACATAGAGGCTCTTA
GATTTAACACCCGCAGCCTTCGGCCCCGAGGCCTAGGGCCCCTTGGGTCTCAGGCCGGGG
GTCTGCCTTGTTTCAATGACTATCGCGAGGTCTTTTACCCTGAGGGTATCAAAATCGTAC
CAGCTAACATAGGGGAGTTATTAACTGCAAGGGGTTAGCATACTGGGCGTATGGACGACG
GTTCAATTCCGAGCTTTAGTCACTCCTTATTTCCTTCCTTCCATGCTGTAAAATGATAGT
AATGTCTAGGGTAGGGCGAGTATATTATCTAACACCTAAAATTGGTAAGAAGTTGAAGGT
ATAGTCTACTCCAGTATGAAAGTATTGGGTAAAAGAGGTCCGTTGCAAGGGGCTCCGATG
AGCTGTGGCAAGGGGTGAAGAATCGCCCGGATTATTGGTGACAGTAGTCATAAATTCGAC
TCATAACGGTGAATCCTAAGGTTTATCAACTATGGAGATACCGTGGGAAGTTATAGTAAT
ACTAGAAACACTTGTACTCTATTGAGTACTATCCCTTCCTGAAGGGAGTTTACTAATAAC
CCCGTAACGACTGATCCGAAAGGAGAGACGTTAGAGATAGAAATCTAATCGTAACACGTC
GACACTCTTATGTTTCAACTAGTTATGAATCTCGACCATACTTGAGTTCATATTATGAAC
AACTTTATCCTTAAGAAGTAATTAGTATTTAGATTATAATTAAGCAGAACTCTACAAACC
CAAAATTAACACCAGCTTACATTAGTGGGCTGGTTCAAGCAGATTGAGGTTTCCATATTG
CCGTGGATCTGCTGCAGCTTACGTATGCAGCTGCAGTGGCAAATCTAATCAATTAGGTAT
TAGGGTTACACCTGAACTCATTTTATCACAACATATTAGTGCCAAACCATTCTTTGAGGT
TTTGATGAACTCTTTAGGAGTAGGTTATCTTACTACCAAGAAGAATGAGGTACAAATCGT
AGTTAATTCTTTACCTCAAATTAAGCAGAAGATTCTGCCTCTGTTAGATCTCTATCCTGT
TAGATCTGGTAAGTTAATCTCTTACCTAAAAGTTCAAACAGGTAAAGAACACCTAGCTTA
AAAAACACCTAACAGATGAAGGATTACAACAGATCATAGATTTGGCTTATAATATGAACA
AAGAGGACAAAGGTCGACGTCTCACAAAGGAAGAGTTTATCCAAAATAGGGGAGGCTAGT
CCAAAAGATGAAGGCTAAATCCTCTCCTAAAAAGGATTTCTCTGATGAGAATTCAGAATT
CTAAAACTAGTAAGAGTTGAAGGTATAGTCTAAACTGGTTCGAAAGAATCAGAATTTATT
GGAAAGGCCAATCTAACCTGGAGATAGCTGGTCTTCCGCGAAACCCGTTTTAGCGGGTCG
CCCATCATTGTAACGTAATCTAACGAAACCCTTGAGGGTTGTTAAGCCTTGGCTTTGGCA
GGCCTTCTTATCAGGGGGCCTTGGTTTCCGTAGGCGGAGCCTGCTTCGACCAAGGAAACC
CCCGGCCTTGAGCCCTACGGGCCCTCTGCAGCTGCATACGTAAGCTGCAGCAGGTCCGGG
GTCCAACCTCTGCCAAAGGCAACCCAAGGCTTGGACGGCGAAGTCAAGCTAATTCGTTAC
TAGATGGTACGGCACTGGAAGCCACGCAGCTTTGCTGCATAATCGGGGGGCTGTCATGGC
TCTATCGATGGCTTCTAACCCCGGAAATGTATAGTATACAATGGTGGGCAATCAGACGTA
TCGTGATAAGGCGATTCGTCAAAAGGGCAACAGCCCAGAACAGGCGCTAAGGTCCCTAAG
GGCCTTCCACTTCCTAAATGCAGGAACACCCTGTAAGTAAACTTACTTGAGAAAGTGAAA
ATAGTTTAATAGGGGCAACCTGCAGGAGTCGAGTTTGATTACTCGGATCCTCAGAGACTA
TACGTAGGTGACGAAATCTTAGTTATGATGAGACCTAGTTTTCGTTAAGACATAGTCCTA
TCTTTACTGAAAGGTAAAGGGGTTATTAAGACTTCATAAGACAATTTAAGGAATAGGGCT
AACTAAAGTGTATAAATAAAGTCACAATCACACCATACTTAGAAGTAAAAAGTGAAAAGT
AATCTTAAACATGCAAATAAGAAATTGTGCCACACCCCTAGTAGTCTATTTTCGTCTTTC
CTTTCTTTGGCTTCAATTTCATCCAGGCTCTTTACGGAATGTGTCTTCTGTCTTGCCTTA
GACTTATGAAGTTTTAATATAACAACCCGTCTTCGGTCCCTCTACGAGATATCTTCTAAG
GAGATAGTATTGAACCGATCGGAGATAAAATCAATGCCCTAAGAACTACTGAGTGAACAC
AAGGCAGTCCTCTCCAGTGTCTCTCCACCAAGTGGGCTTGGCTTCCAGGCCTATCCTTTC
ATATTTCATAAGGATAACAATTTGGCTATATGCTGGAAACTCCTGTAAGATGTTAGATGG
TCATACCTAAACCCTATTACCAACAATTCTAACATAGGGACAATCAGCAGGGAAGTTAAA
AGAATTAACCCCTCAACGACCACACGCCGAAACTAACTACAAGTAGTTAATAAATCTACA
TCCCGGTATCCTGACCTTTTCAATTACTCCACACCTACCAAGAAATAGTCAATCTTGCCT
ACAACATGAATTTAGAAGGGAAACGTAGAAAACTGCCCAAAGAGGAGTACTTAAAATCTG
TAAATTTCAAAGCCCCCTGTTCATAAGAGGTCCCAAGAAAGCAGAGGTGTGGGGATCACT
AAAAGAGCGGGGACCTTGGTTTCCGTAGGCGGAGCCTGCTTCGACCAAGGAAAGCCCCGG
CCCTTGACCCATAGGGCCCCCTGCAGCTGCATACGTAAGCTGCAGCAGGTCCGGGGGCAA
GGGGGGCTCTTTATTTACTGTTTCCTTTAGGGTCGGGGTTTGATAAATACCTGTAGTTTA
GTATGATATGGTCTAAACATGGTTGAAAATTCATGATGCAATATTGTGGAAGCAGCCACC
TTTTAGCGAAAGCGTAACAGCTCAGTGGTCTAAGCTCCCCTGCCAGGTTTATCTTCCTAG
CGGAACCCCTGCTCCTCCCATAAGGAGGCCTTTCAGGGCTCCAGAGCGAAAAGAAGCCTA
GGCTTGCCCCGACCCGAGGTTGCCTCGGATCAAGCCGAGGCCCTGTCCCTTGGCAACCCG
AGGTCTCGGGACCCGGTTGCCAAATGGCAGGCCATCGGTCTGCCCGGGCAACCCCCCGGC
CTTGAGCCCAAGGGCCCCCCTGCAGCTGCATACGTAAGCTGCAGCAGGTCCGGGGGCCA
>C688J14111_10004472
GCCATCGGTCTGCCCGGGCAACCCCCCGGCCTTGAGCCCAAGGGCCCCCCTGCAGCTGCA
TACGTAAGCTGCAGCAGGTCCGGGGGCCAAGGTTGGCCAAGGCAAGCTCCGGTAGTTTGG
CAGGGTACATTGCCTAGTGAGGGCGCCGAGAATGTAACGGGTCTATAGTAGTTGTCTCCC
TGGAACCCGGTTTGCCGACCCATGAGCCTGGAAGGCCCGGGGGTAGGCCAGCCAAACTCT
CTCGTAGGGAGCCCAGGGGGGCGCGGCAGCCGGCACAGGCGCAGAGCTCCTCCGCCTGCC
TCACCGAAACCCTGTCCTAGGCGCCAAATTCTGGGGGTAGCGGAATACCCAGCAAATGGA
ATGAAGGTGGCTCATCGAGCCGGTGGACATAGCTGGGCTGAGAATGCTGACATGAGTAGC
CTCAAAGGAGGGGAATTCCCTCTTCGCCGAAAGCAGAAGGGTTTCATATGTTAGGTCCAT
ACCAGCATGAGTAAAGCAGCGGCCTCTAAGGCAGCTTAGGGTGGCGGATCCCGAAGGGCT
TCGAAGGAGTCAGAAGGACCAAAACTCTGCCTGGCCAAGCCCCCGAGGTTGCCTCAGGTC
AAGCCGAGGGCCTGTCCCTTGGCAACCCGAGGTCTCGGCCTTGGGCTGACACGAGCGGTG
CCGATGAGTAACTCTTCTGTAGGGCAGTAACCTTCCTTATAAGTATACCTTGCCGTTACG
GACCCTGGTCATACCCTGCCCCAACTCTCGCACACAAGCGAGTTGTGCTGGAGGCTCTGC
CTTCGGCAAGTCTGCCCGGGCAACCCCCCGGCCTTGAGCCCAAGGGCCCCCCTGCAGCTG
CATACGTAAGCTGCAGCAGGTCCGGGGGCCAAGCTTGGCCCAAGGAGACCTTGGTTTCCG
TAGGCGGAGCCTGCTTCGACCAAGGAAACCTGTCGGCAGACCAGGTCCAAGGCTCCCTTG
GGCATAGCCCGGTAGGCAACGCCCTGTCGGGCGTTCTGATGGGAGCTACTGTAAAGCGAT
GGCGTAGTAATCATAACCACAGATAGTATGACACTATCAGAGGTGGACCAGTTGTGCTCT
GTTCTGAAGGATCGCTATGGTAATGAATTCTCTCATATTGCTCATAATAAAGCTAAGGAG
CAGTACATTACACTGTACCTAAAAGTGAGGTTACCAAATGGAAATCTCTGGTATCTAAAC
ATATTCCTGCTCCGGATGCGTTACCTAGTAGGATTCTAATTTAATCACTTTCTATATTTA
TAGCTATTGCTCTTTTCATGATAAATCCCAAGGAGATTAGCTTAATGGAAGAGCGGGTGC
CTTACAAGCACAAGGTGGTAGTTCGATTCTGCCATCTCCTATTCCTTGTGTAATAGTGAA
TGATTCTTTATATACTACAATTAGAATATAACCTTGTATTAAAGTGAACTAAAGAAACCA
CTTGGGTGGGTTACCCTCCCTGTGTGATTTAGTTAGAGTCAAATCTTTGCTATTGCCTAG
CTATACCAAATTACTTAGAGGGGTATTTTTGTATTGGAAAAACGAAGAGTATGCTAAGAG
GTGGACCCGCTAGTTTTGTCAAGGCATAATATAATTGGGCCTATTATAGCCAATAGTAAA
ATGATCCCCGCATAAATTAACCAAAGAGGGTATACAGTATATAAACATACGCCTAATGAA
TGAATATTAGAGAAGGCCGCAAAGAGGTTCGTCCACTGGAGGACTGAAGGATCAGAGATG
TGAGCAATGCCTAGAGTGGTTTGGTCAAACCAACTGTAAAGAGTGTCACCTCTAAATAAT
GGTGAGCCGGTTAGGGTCCAAAGGAACGGCGTTCCGACAAGGAATGCAACAGGATATACT
TTGCTGGCCTCTTCTCCTGAAGAGCTTAATTCAGCTAGCTTGATATCGAGCATCATTATT
ACGAATAGAAAGAGTATGGCTATTGCCCCTACGTATATGATGAGGTAACTCAGGGCTAGA
AAGGTTAGTCCCAGAAGAGCTAGGTAAGCCGAGACGGTAATGAAGACAGCTATCAGGAAA
AGCACAGCGAGGATGGGGTTTACCGCTGTTATAACAAAGATAGCAGAGAGCACAGCCATG
AAGGGCAGTAATTCCAGTAGAATTGGACTCATTACTTTAGGGTTTGCTTTTGCTTACTTC
TTGGTACGGAAAAGTCTCTCTTTCTCTTAAGAGTGGGGCAATTGAAAACAAGGCTAATTG
TATTAGAAAGCCATAGGGTACTAGGAAACTAGGCAAACCCTCGGTCCCGGACTTGAGCCC
TACGGACCCCCCGGGGGCCAAGGTTAGCGAGTGATTTTGGAATAATGTTTAGAAGGTATC
ATCGGATGCTATACTCATACTCGCCCTCATCTAGAAGTGTTTTCGGTATTTCCTAATAAT
GTGCTAATATCAATTCAGTCTTGGGCAGAACTTGGCCCCCGGAGGATCCCAACTTTCAGT
TGTTAAACTCCTGCCCTAGGCCTGATGCCTCCCTAAGTTAACAAACAGTGTGGACCTGTA
AGAGTCTCGAGGGGTAGGGGAGTAAAAATTAGAGCTAAAAAGGACAACCAGCCCTTAAGG
CTCGTGCTAAAGCAGGCGTCATGAAACGTGACGGAAGCCTTCGCTTAAGATACTGGTGAA
GACCGGTTTTATTGGACAAGTATGATAAGCAAAAAAGCGTATTTTTAAGCAAAATGCTTG
CTCGCTGGCTCTTCTCAACCAATGCTAAAGATATTGGGACTCTTTACCTCATTTTTGCCC
TGTTTGCTGGTAGACTATTTGTCATGCCTGCTCTAAATCTTGCTATATGCAGGGAAGGTT
CTACACTCTTGCAGTACTTCATTAACTTTGTTTTCGAAGTCAAAATCTGGAGAGTAACTA
TTAGGAACTTATCTGCAGAAAACTTGTTAACAAGGATTCTCAGAGACTTTACGCAAGAGC
TCTTAACCAAATTTACTATCTCTACTTATATTTTAGAATCATTTGCGGCTAATGTACAGA
AATCTTCACATATAAGAGAAGTCAATAATTCTACACCTAACACATCTGGACAATTAGGTC
CTATTTAGCAGGTTTAATAGAATCTGATGGTGTTTTAATAACACCAAAGAACTCTTCAAC
CACCCCTACAATTTATATATCTTTACACGAAAAAGACAGACCATTTGCAGAACATTTAAA
AAATTACCTTGGTTATGGTTCTATTCAATTAGAAGTCAGTTCTCCAAATGCTATACGGTT
TGTTATACAAAACAAAGAGGGTATTATTGATATTTTAAACCTAATTAATGGTTACTTTCG
AACACCTAAAATTAGTAGGCTACATGCTATGATCGATTGGGTTAATACAAAACCAAATTA
CTCATTAAAACCTATAACTAAATTACCTTTAGATACTTCTCAACTAAATACTAACAGTTG
GTTAGCAGGATTCGCAGAAGGTGATGCTAGTTTCCAAATTAGAACAACTGAAGGGAGATA
TCGTCACGTAGCAACTTCATTTGAATTAAGCCAGGGTAGAGATGATCCAGCATTATTTCA
AGCTTATAAACCAATTATGGAAACAATAGCTTCCTTTTTACTTGCTAATTTAAGTGTTAT
TCATTTAAGTAATTTTAATCGAACAGGAAAACAATTATTTTGGAGAGCACGTAACAGTAG
TCAAGCTGGTTCGCAAATTGTAGCTAATTATTTTACTCAATTTCCACTCTTCAGTTCTAA
ATATCTAGATTTTGTAGGTTGGAAAAAAGCACATATGCTCATTATGTCAAAGGCTCACTT
TAATAAATATGGAGAAGAGGGGTTTAACCTTATTAAAACTATAAAAGCTAATAATAA
>C688J14111_10007765
GTAACACGTCGACACTCTTATGTTTCAACTAGTTATGAATCTCGACCATACTTGAGTTCA
TATTATGAACAACTTTATCCTTAAGAAGTAATTAGTATTTAGATTATAATTAAGCAGAAC
TCTACAAACCCAAAATTAACACCAGCTTACATTAGTGGGCTGGTTCAAGCAGATTGAGGT
TTCCATATTGCCGTGGATCTGCTGCAGCTTACGTATGCAGCTGCAGTGGCAAATCTAATC
AATTAGGTATTAGGGTTACACCTGAACTCATTTTATCACAACATATTAGTGCCAAACCAT
TCTTTGAGGTTTTGATGAACTCTTTAGGAGTAGGTTATCTTACTACCAAGAAGAATGAGG
TACAAATCGTAGTTAATTCTTTACCTCAAATTAAGCAGAAGATTCTGCCTCTGTTAGATC
TCTATCCTGTTAGATCTGGTAAGTTAATCTCTTACCTAAAAGTTCAAACAGGTAAAGAAC
ACCTAGCTTAAAAAACACCTAACAGATGAAGGATTACAACAGATCATAGATTTGGCTTAT
AATATGAACAAAGAGGACAAAGGTCGACGTCTCACAAAGGAAGAGTTTATCCAAAATAGG
GGAGGCTAGTCCAAAAGATGAAGGCTAAATCCTCTCCTAAAAAGGATTTCTCTGATGAGA
ATTCAGAATTCTAAAACTAGTAAGAGTTGAAGGTATAGTCTAAACTGGTTCGAAAGAATC
AGAATTTATTGGAAAGGCCAATCTAACCTGGAGATAGCTGGTCTTCCGCGAAACCCGTTT
TAGCGGGTCGCCCATCATTGTAACGTAATCTAACGAAACCCTTGAGGGTTGTTAAGCCTT
GGCTTTGGCAGGCCTTCTTATCAGGGGGCCTTGGTTTCCGTAGGCGGAGCCTGCTTCGAC
CAAGGAAACCCCCGGCCTTGAGCCCTACGGGCCCTCCCCCTCGCCCTTCCAGGCGGGCAA
GCCGCCCGTCTGGGGCGAGGGTCTGCAGCTGCATACGTAAGCTGCAGCAGGTCCGGGGTC
CAACCTCTGCCAAAGGCAACCCAAGGCTTGGACGGCGAAGTCAAGCTAATTCGTTACTAG
ATGGTACGGCACTGGAAGCCACGCAGCTTTGCTGCATAATCGGGGGGCTGTCATGGCTCT
ATCGATGGCTTCTAACCCCGGAAATGTATAGTATACAATGGTGGGCAATCAGACGTATCG
TGATAAGGCGATTCGTCAAAAGGGCAACAGCCCAGAACAGGCGCTAAGGTCCCTAAGGGC
CTTCCACTTCCTAAATGCAGGAACACCCTGTAAGTAAACTTACTTGAGAAAGTGAAAATA
GTTTAATAGGGGCAACCTGCAGGAGTCGAGTTTGATTACTCGGATCCTCAGAGACTATAC
GTAGGTGACGAAATCTTAGTTATGATGAGACCTAGTTTTCGTTAAGACATAGTCCTATCT
TTACTGAAAGGTAAAGGGGTTATTAAGACTTCATAAGACAATTTAAGGAATAGGGCTAAC
TAAAGTGTATAAATAAAGTCACAATCACACCATACTTAGAAGTAAAAAGTGAAAAGTAAT
CTTAAACATGCAAATAAGAAATTGTGCCACACCCCTAGTAGTCTATTTTCGTCTTTCCTT
TCTTTGGCTTCAATTTCATCCAGGCTCTTTACGGAATGTGTCTTCTGTCTTGCCTTAGAC
TTATGAAGTTTTAATATAACAACCCGTCTTCGGTCCCTCTACGAGATATCTTCTAAGGAG
ATAGTATTGAACCGATCGGAGATAAAATCAATGCCCTAAGAACTACTGAGTGAACACAAG
GCAGTCCTCTCCAGTGTCTCTCCACCAAGTGGGCTTGGCTTCCAGGCCTATCCTTTCATA
TTTCATAAGGATAACAATTTGGCTATATGCTGGAAACTCCTGTAAGATGTTAGATGGTCA
TACCTAAACCCTATTACCAACAATTCTAACATAGGGACAATCAGCAGGGAAGTTAAAAGA
ATTAACCCCTCAACGACCACACGCCGAAACTAACTACAAGTAGTTAATAAATCTACATCC
CGGTATCCTGACCTTTTCAATTACTCCACACCTACCAAGAAATAGTCAATCTTGCCTACA
ACATGAATTTAGAAGGGAAACGTAGAAAACTGCCCAAAGAGGAGTACTTAAAATCTGTAA
ATTTCAAAGCCCCCTGTTCATAAGAGGTCCCAAGAAAGCAGAGGTGTGGGGATCACTAAA
AGAGCGGGGACCTTGGTTTCCGTAGGCGGAGCCTGCTTCGACCAAGGAAAGCCCCGGCCC
TTGACCCATAGGGCCCCCTGCAGCTGCATACGTAAGCTGCAGCAGGTCCGGGGGCAAGGG
GGGCTCTTTATTTACTGTTTCCTTTAGGGTCGGGGTTTGATAAATACCTGTAGTTTAGTA
TGATATGGTCTAAACATGGTTGAAAATTCATGATGCAATATTGTGGAAGCAGCCACCTTT
TAGCGAAAGCGTAACAGCTCAGTGGTCTAAGCTCCCCTGCCAGGTTTATCTTCCTAGCGG
AACCCCTGCTCCTCCCATAAGGAGGCCTTTCAGGGCTCCAGAGCGAAAAGAAGCCTAGGC
TTGCCCCGACCCGAGGTTGCCTCGGATCAAGCCGAGGCCCTGTCCCTTGGCAACCCGAGG
TCTCGGGACCCGGTTGCCAAATGGCAGGCCATCGGTCTGCCCGGGCAACCCCCCGGCCTT
GAGCCCAAGGGCCCCCCTGCAGCTGCATACGTAAGCTGCAGCAGGTCCGGGGGCCAAGGT
TGGCCAAGGCAAGCTCCGGTAGTTTGGCAGGGTACATTGCCTAGTGAGGGCGCCGAGAAT
GTAACGGGTCTATAGTAGTTGTCTCCCTGGAACCCGGTTTGCCGACCCATGAGCCTGGAA
GGCCCGGGGGTAGGCCAGCCAAACTCTCTCGTAGGGAGCCCAGGGGGGCGCGGCAGCCGG
CACAGGCGCAGAGCTCCTCCGCCTGCCTCACCGAAACCCTGTCCTAGGCGCCAAATTCTG
GGGGTAGCG
>C688J14111_11205495
AATACAGGATCTATGTTAAAACCAACTCTATGGTTCAATTCCGAGCTTTAATCTCTCCTT
ATTTCTTTCCTTCCATGCTGTACAAATTACAGTAAGGTCTATCGGGTAGGGTCAGGGTAG
GGAGTATATATTATCTAACACCTAAAATTGGTAAGAAGTTGAAGGTATAGTCTACTCCAG
TACGAAAGTATTGGGCAATAGGTCCGTTGCAAGGGGCTCCGATGAGCTGTGGCAAGGGGT
GATTAATCGCCCGGATTATTGGTGACAGTAATCATAAT
