>Ga0063454_100243295
TCTGCAGCTGCATACGTAAGCTGCAGCAGGTCCGGGGTCCAACCTCTGCCAAAGGCAACC
CAAGGCTTGGACGGCGAAGTCAAGCTAATTCGTTACTAGATGGTACGGCACTGGAAGCCA
CGCAGCTTTGCTGCATAATCGGGGGGCTGTCATGGCTCTATCGATGGCTTCTAACCCCGG
AAATGTATAGTATACAATGGTGGGCAATCAGACGTATCGTGATAAGGCGATTCGTCAAAA
GGGCAACAGCCCAGAACAGGCGCTAAGGTCCCTAAGGGCCTTCCACTTCCTAAATGCAGG
AACACCCTGTAAGTAAACTTACTTGAGAAAGTGAAAATAGTTTAATAGGGGCAACCTGCA
GGAGTCGAGTTTGATTACTCGGATCCTCAGAGACTATACGTAGGTGACGAAATCTTAGTT
ATGATGAGACCTAGTTTTCGTTAAGACATAGTCCTATCTTTACTGAAAGGTAAAGGGGTT
ATTAAGACTTCATAAGACAATTTAAGGAATAGGGCTAACTAAAGTGTATAAATAAAGTCA
CAATCACACCATACTTAGAAGTAAAAAGTGAAAAGTAATCTTAAACATGCAAATAAGAAA
TTGTGCCACACCCCTAGTAGTCTATTTTCGTCTTTCCTTTCTTTGGCTTCAATTTCATCC
AGGCTCTTTACGGAATGTGTCTTCTGTCTTGCCTTAGACTTATGAAGTTTTAATATAACA
ACCCGTCTTCGGTCCCTCTACGAGATATCTTCTAAGGAGATAGTATTGAACCGATCGGAG
ATAAAATCAATGCCCTAAGAACTACTGAGTGAACACAAGGCAGTCCTCTCCAGTGTCTCT
CCACCAAGTGGGCTTGGCTTCCAGGCCTATCCTTTCATATTTCATAAGGATAACAATTTG
GCTATATGCTGGAAACTCCTGTAAGATGTTAGATGGTCATACCTAAACCCTATTACCAAC
AATTCTAACATAGGGACAATCAGCAGGGAAGTTAAAAGAATTAACCCCTCAACGACCACA
CGCCGAAACTAACTACAAGTAGTTAATAAATCTACATCCCGGTATCCTGA
