3300001686
3300002568
3300002568
3300002568
3300001305
3300001305
3300001305
3300001305
3300004081
3300004153
